0 *x** -> E 0
0 *E** -> X 1

1 x*** -> N 0
1 Nx** -> X 0
1 NE** -> S 3

2 N*x* -> W 2
2 x*W* -> X 1
2 N*Wx -> X 3

3 **Wx -> S 3
3 **x* -> W 3
3 **WS -> x 1
