0 *E** -> X 3
0 *x** -> E 1

1 ***S -> x 0
1 ***x -> S 2

2 **W* -> x 1
2 **x* -> W 3

3 N*** -> x 2
3 x*** -> N 0
